XXXXXXXXXXXXXXXXXXXX
X S    XXXX   X F  X
X    XXXXXX   XXXXXX
X    XX            X
X            XXX   X
XXXXXXXXXXXXXXXXXXXX
