XXXXXXXXXXXXXXXXXX
XS X          X FX
X  X      XXXXX  X
X  X  X   X   X  X
X  X  X   X   X  X
X     X          X
X     X          X
XXXXXXXXXXXXXXXXXX
